DateTime	KEYWORD1

WD_SUNDAY	LITERAL1
WD_MONDAY	LITERAL1
WD_TUESDAY	LITERAL1
WD_WEDNESDAY	LITERAL1
WD_THURSDAY	LITERAL1
WD_FRIDAY	LITERAL1
WD_SATURDAY	LITERAL1

FORMAT_12HOUR	LITERAL1
FORMAT_24HOUR	LITERAL1

AM	LITERAL1
PM	LITERAL1

DD_MM_YYYY	LITERAL1
DD_M_YYYY	LITERAL1
D_MM_YYYY	LITERAL1
D_M_YYYY	LITERAL1
MM_YYYY	LITERAL1
M_YYYY	LITERAL1
YYYY_MM_DD	LITERAL1
YYYY_M_DD	LITERAL1
YYYY_MM_D	LITERAL1
YYYY_M_D	LITERAL1
YYYY_MM	LITERAL1
YYYY_M	LITERAL1
DD_MM_YY	LITERAL1
DD_M_YY	LITERAL1
D_MM_YY	LITERAL1
D_M_YY	LITERAL1
MM_YY	LITERAL1
M_YY	LITERAL1
YY_MM_DD	LITERAL1
YY_M_DD	LITERAL1
YY_MM_D	LITERAL1
YY_M_D	LITERAL1
YY_MM	LITERAL1
YY_M	LITERAL1
DD_MM	LITERAL1
DD_M	LITERAL1
D_MM	LITERAL1
D_M	LITERAL1
MM_DD	LITERAL1
M_DD	LITERAL1
MM_D	LITERAL1
M_D	LITERAL1

HH_MM_SS_mmm	LITERAL1
H_M_S_m	LITERAL1
HH_MM_SS	LITERAL1
H_M_S	LITERAL1
HH_MM	LITERAL1
H_M	LITERAL1
M_S	LITERAL1
MM_SS	LITERAL1
M_S_m	LITERAL1
MM_SS_mmm	LITERAL1
S_m	LITERAL1
SS_mmm	LITERAL1

MILLISECOND	LITERAL1
SECOND	LITERAL1
MINUTE	LITERAL1
HOUR	LITERAL1
DAY	LITERAL1
WEEK	LITERAL1
MONTH_31	LITERAL1
MONTH_30	LITERAL1
MONTH_29	LITERAL1
MONTH_28	LITERAL1
MONTH	LITERAL1
YEAR	LITERAL1
LEAP_YEAR	LITERAL1

null_time	LITERAL1

time_s	KEYWORD3

hour	KEYWORD2
minute	KEYWORD2
second	KEYWORD2
milliseconds	KEYWORD2
year	KEYWORD2
month	KEYWORD2
day	KEYWORD2
weekday	KEYWORD2

MillisTimer	KEYWORD1

setInterval	KEYWORD2
getInterval	KEYWORD2
remainingTime	KEYWORD2
onHandle	KEYWORD2
handleTime	KEYWORD2
reset	KEYWORD2
enabled	KEYWORD2
enable	KEYWORD2
repeat	KEYWORD2

TimeSpan	KEYWORD1

set	KEYWORD2
get	KEYWORD2
days	KEYWORD2
hours	KEYWORD2
minutes	KEYWORD2
seconds	KEYWORD2

Alarm	KEYWORD1

setAlarm	KEYWORD2
getAlarm	KEYWORD2
onDays	KEYWORD2
setSynch	KEYWORD2
resetSynch	KEYWORD2
resetProtection	KEYWORD2
onRinging	KEYWORD2
handleAlarm	KEYWORD2

DateTime	KEYWORD1

millisecondsUTC	KEYWORD2
hourUTC	KEYWORD2
minuteUTC	KEYWORD2
secondUTC	KEYWORD2
yearUTC	KEYWORD2
monthUTC	KEYWORD2
dayUTC	KEYWORD2
weekdayUTC	KEYWORD2
daysUTC	KEYWORD2
days	KEYWORD2
setTimeSpan	KEYWORD2
getTimeSpan	KEYWORD2
setUTC	KEYWORD2
setDateUTC	KEYWORD2
set	KEYWORD2
setDate	KEYWORD2
setUNIX	KEYWORD2
getUNIX KEYWORD2
getUTC	KEYWORD2
get	KEYWORD2
getDate	KEYWORD2
getDateUTC	KEYWORD2
setTimezone	KEYWORD2
getTimezone	KEYWORD2
DST	KEYWORD2
isDST	KEYWORD2
isPM	KEYWORD2
isAM	KEYWORD2
format	KEYWORD2
toLongTimeString	KEYWORD2
toShortTimeString	KEYWORD2
toLongDateString	KEYWORD2
toShortDateString	KEYWORD2
operatorsUseUTC	KEYWORD2
onSynch	KEYWORD2
synchNow	KEYWORD2
synchInterval	KEYWORD2
synchEnable	KEYWORD2
synchEnabled	KEYWORD2
remainingSynchTime	KEYWORD2
raw	KEYWORD2
copy	KEYWORD2

daysFromYearZero	KEYWORD2
dayInYear	KEYWORD2
daysInMonth	KEYWORD2
isLeapYear	KEYWORD2
toStr64	KEYWORD2
yearFromMillis	KEYWORD2

setNTPserver	KEYWORD2
NTPclockID	KEYWORD2
NTPlastError	KEYWORD2
NTPinterval	KEYWORD2
NTPenable	KEYWORD2
NTPenabled	KEYWORD2
NTPsynchNow	KEYWORD2
remainingNTPsynchTime	KEYWORD2
NTPhandler	KEYWORD2
onNTPsynch	KEYWORD2
updateTZ_DST_lastError	KEYWORD2
updateTZ_DST	KEYWORD2

NTP_NONE	LITERAL1
NTP_OK	LITERAL1
NTP_NOT_FOUND	LITERAL1
NTP_TIMEOUT	LITERAL1
NTP_BAD_RESPONSE	LITERAL1
NTP_NO_INTERNET	LITERAL1
